333333333332222
331113333332222
333113333333222
333113333333222
333333333333332
222333333333333
222233333333333
222233333333333
422223333333333
422233333333333
442333333113333
444333333111333
444233333111333
442222333311333
222222233333333