111111122222222
111111122222222
111111122222222
111111122222222
111111122222222
111111122222222
111111122222222
111111122222222
333333344444444
333333344444444
333333344444444
333333344444444
333333344444444
333333344444444
533333344444444